NO ./res/greystone.xpm
SO ./res/bluestone.xpm
WE ./res/mossy.xpm
EA ./res/wood.xpm
F 96,96,96
C 75,190,255
11111111111111111111111111111111111111111111111111
10000001000000000000000000000000000000000000000001
10000000000001000000000000000000000000000000000001
10000001000001000000000000000000000000000000000001
10000001000000000010001110000000000000000000000001
10000001000000000000001110000000000000000000000S01
10100101000000000000001110000000000000000000000001
10000001000000000000000000000000000000000000000001
10000001000000000000000000000000000000000000000001
11111111111111111111111111111111111111111111111111